0,0,0,0,0,0,0,1,1,1,1,1,1,0,2,2
0,0,0,0,0,0,0,1,1,1,1,1,1,0,2,2
0,0,0,0,0,0,0,1,1,1,1,0,0,0,0,0
0,0,0,0,0,0,0,1,1,1,0,0,0,0,0,0
4,4,4,4,8,8,0,0,16,16,16,0,0,0,0,0
4,4,4,4,8,8,0,0,16,16,16,0,0,0,0,0
1,1,1,1,0,0,0,0,0,0,0,0,0,0,0,0
0,0,0,0,0,0,0,0,0,0,0,0,0,0,0,0
